5551111111166631
5550000000066632
5551111111166633
4444433334444434
5551111111166635
5550000000066636
5551111111166635
4444433334444434