555111111111111111111111
555000000000000000000001
555111111111112221111101
101111111111112221111101
100001111111112221111101
111101111110000000000001
112222211110111111011111
122222221110111111011111
122222221110111111011111
112222211110111111011111
111101111110111111011111
444404444440444443334444
444404444440444443334444
444404444440444443334444
111102222220111111011111
111102222220111111011111
111102222220111111011111
111102222220111111011111
111102222220111111011111
100000000000000000011111
101111111111122221111111
101111111111122221111111
101111111111122221111666
100000000000000000000666
111111111111111111111666