5511111111111111111111
5511111111111111111111
1011111111111111111111
1000000001111111111111
1011111101111111111111
1011111101111111111111
1011111101111111111111
1011111101111111111111
1011111101111111111111
4044444404444444444444
4044444404444444444444
1011111101111111111111
1000000001111111111111
1111111101111111111111
1111111101111111111111
1111111101111111111111
1111111101111111111111
1111111101111111111111
1111111100000000000000
1111111111111111111000
1111111111111111111111
1111111111111111111166
1111111111111111111166